1111111111111111111111
10000000000011111
10000001111000001
11110N00000011111
10000001111000001
11111111111111111