EA tests/textures/Dehydrated_Earth_64x64.png
NO tests/textures/Green_Wall_Rocks_64x64.png
WE
SO tests/textures/Rocky_Road_64x64.png

F 93,138,168
C 83,75,79

                11111
               1100011
               1000001
11111111111111110000011
10001000000100011000001
100010010001000111110011
1000000100000001000110011
11111111000100010000110011
10000000000111110000011001
10111111000100010010001001
100000010000000100100010011
1000000100010001001000110011
1111111100011111001100011001
1000100000000000000110001001
1000100000000000000110001001
1100100000010001000110001001
 110100000010N01100100000001
  10111110010001000000000111
  100000100111111111111111
  1100000011
   11111111
