EA tests/textures/Graffiti_East_64x64.png
NO tests/textures/Graffiti_North_64x64.png
WE tests/textures/Graffiti_West_64x64.png
SO tests/textures/Graffiti_South_64x64.png

F 59,122,87
C 119,181,254

111111111111111111111111111111111111111111111111111111111111
100000000000000000000000000000000000000000000000000000000001
100000000000000000000000000000000000000000000000000000000001
100E000000000000000000000000000000000000000000000000000000011
100000000000000000000000000000000000000000000000000000000001
100000000000000000000000000000000000000000000000000000000001
111111111111111111111111111111111111111111111111111111111111
