EA tests/textures/Graffiti_East_64x64.png
NO tests/textures/Graffiti_North_64x64.png
WE tests/textures/Graffiti_West_64x64.png
SO tests/textures/Graffiti_South_64x64.png

F 59,122,87
C 119,181,254

1111111
1000001
1000001
100S001
1000001
1000001
1000001
1000001
1000001
1000001
1000001
1000001
1000001
1000001
1000001
1000001
1000001
1000001
1000001
1000001
1000001
1000001
1000001
1000001
1000001
1000001
1000001
1000001
1000001
1000001
1000001
1000001
1111111
