EA tests/textures/Dehydrated_Earth_64x64.png
NO tests/textures/Green_Wall_Rocks_64x64.png
WE tests/textures/Dirt_Road_64x64.png
SO tests/textures/Rocky_Road_64x64.png

F 93,138,168
C 83,75,79

                11111
       11111   1100011
  111  10001   1000001
111111111111111100000110 1
10001000000100011000001111
100010010001000111110011
1000000100000001000110011
11111111000100010000110011000
1000000000011111000001100111
111111110001000100100010011111111
10000  10000000100100010010000001
1   00010001000100100011001111001
1111111100011111001100011001 1001
100010000000000000011000100111001
100010000000000000011000100000011
11001000000100010001100010000011
 110100000010N01100100000001111
  10111110010001000000000111
  100000100111111111111111
  110000001000   1
   1111111
