EA tests/textures/Dehydrated_Earth_64x64.png
NO tests/textures/Green_Wall_Rocks_64x64.png
WE tests/textures/Dirt_Road_64x64.png
SO tests/textures/Rocky_Road_64x64.png

F 59,122,87
C 119,181,254

   
                                1111
               11             11100111
               1111           10000001
   1111111111111001     111   11100111
   100000000000000111    1      1001
   1111100111001100011          1001
      1110111111110001111111111110011111111111
      10100000000000000000000000000000000000W1    
     11110000000000000000000000000000000000011
     1000000000000000000000000000000000000111
     11100111111111111001111111111111111111
       1111      100000001
         1       100000001        0001
                 111111111


