EA tests/textures/Dehydrated_Earth_64x64.png
NO tests/textures/Green_Wall_Rocks_64x64.png
WE tests/textures/Dirt_Road_64x64.png
SO tests/textures/Rocky_Road_64x64.png

F 59,122,87
C 119,181,254

111111111111111111111111111111111111111111111111111111111111
100000000000000000000000000000000000000000000000000000000001
1E0000000000000000000000000000000000000000000000000000000001
100000000000000000000000000000000000000000000000000000000001
111111111111111111111111111111111111111111111111111111111111
