NO ./textures_ids/nord.png
SO ./textures_ids/south.png
WE ./textures_ids/west.png
EA ./textures_ids/east.png

F 184,113,243
C 51,12,227

1                           1
11                         11
111                       111
1111                     1111
11111                   11111
111111                 111111
1111111               1111111
11111111             11111111
100000001           100000001
1000000001         1000000001
10000000001       10000000001
100000000001     100000000001
1000000000001   1000000000001
10000000000001 10000000000001
10000000000000100000000000001
10000000000000000000000000001
10000000000000000000000000001
10000000000000000000000000001
11111111111111111111111111111