NO textures/Brick_Wall_64x64.png
EA textures/Dirt_Road_64x64.png
WE textures/Brick_Wall_Cracked_64x64.png	
SO textures/stone_64x64.png

F 87,FF,AA
C 87,ce,eb

111111111111111111
1000001000000000N11
100001 1000000000001
1000001011000000011
100000000000000001
100000000000000001
100000000111000001
101110000000000001
111111111111111111
