NO textures/Brick_Wall_64x64.png
EA textures/Dirt_Road_64x64.png
WE textures/Brick_Wall_Cracked_64x64.png	
SO textures/stone_64x64.png

F 87,FF,AA
C 87,ce,eb

1111111111111111111111111
1000000000110000000000001
1000000000110000000000001
1000000000000000000000001
1000000000110000000000001
1000000000110000000000001
1000000000110000000000001
100000000011000000N000001
1000000000110000000000001
1000000000110000000000001
1000000000110000000000001
1111111111111111111111111
