NO textures/Water_64x64.png
SO textures/Water_64x64.png
EA textures/Water_64x64.png
WE textures/Water_64x64.png

F 107,79,58
C 135,206,250

  
111111111111111111111111111111111
100001110000000000000100000000001
100001100000000000000000000000001
100001100000000000001111111111111
10000100000000000E000000000000001
100001000000000000001111111111111
100000000000000000000000000000001
100000000000010000000000000000001
100000000000000000000000000000001
100000000010000000000000000000001
100000000000000000000000000000001
100000000000000000000000000000001
111111111111111111111111111111111
