NO textures/Brick_Wall_64x64.png
EA textures/Dirt_Road_64x64.png
WE textures/Brick_Wall_Cracked_64x64.png	
SO textures/stone_64x64.png

F 6B,4F,3a
C 87,Ce,FA

111111111111111111
1N0000000000000001
110000000000000001
100000001100000001
100000000000000001
100000000000000001
100000000111000001
101110000000000001
111111111111111111
