NO textures/Tile/Tile_16-128x128.png
SO textures/Bricks/Bricks_05-128x128.png
WE textures/Wood/Wood_17-128x128.png
EA textures/Tile/Tile_11-128x128.png

F 107,79,58
C 135,206,250

1                           1
11                         11
101                       101
1001                     1001
10001                   10001
100001                 100001
1000001               1000001
10000001             10000001
100000001           100000001
1000000001         1000000001
10000000001       10000000001
100000000001     100000000001
1000000000001   1000000000001
10000000000001 10000000000001
10000000000000100000000000001
10000000000000000000000000001
10000000000000N00000000000001
10000000000000000000000000001
10000000000000100000000000001
10000000000001 10000000000001
1000000000001   1000000000001
100000000001     100000000001
10000000001       10000000001
1000000001         1000000001
100000001           100000001
10000001             10000001
1000001               1000001
100001                 100001
10001                   10001
1001                     1001
101                       101
11                         11
1                           1
