NO textures/Bricks/Brick_Wall_64x64.png
EA textures/Dirt_Road_64x64.png
WE textures/Bricks/Brick_Wall_Cracked_64x64.png	
SO textures/Bricks/stone_64x64.png

F 107,79,58
C 135,206,250

                     11111
111111111111        1000001   111111111111111111111
1000000000W1       100111001  100000000000000000001
101111111111      1001   1001 111111111101111111111
101               10111111101          101
101              1000000000001         101
101             100111111111001        101
1011111111111  1001         1001       101
1000000000001  1001         1001       101
1111101111111  1011         1011       101
    10111111111101          10111111111101
    10000000000001          10000000000001
    11111111111111          11111111111111