NO textures/Bricks/Brick_Wall_64x64.png
EA textures/Dirt_Road_64x64.png
WE textures/Bricks/Brick_Wall_Cracked_64x64.png	
SO textures/Bricks/stone_64x64.png

F 135,255,170
C 135,206,235

   111111 
11110N001
11 100001
111111111
