NO textures/Bricks/Brick_Wall_64x64.png
EA textures/Dirt_Road_64x64.png
WE textures/Bricks/Brick_Wall_Cracked_64x64.png	
SO textures/Bricks/stone_64x64.png

F 107,79,58
C 135,206,250

111111111111111
100000000000001
110101110110011111111
110011111010000000001
1000100000W1111111101
11011111001       101
 101    101       101
 101    101       101
 101    101       101
 101    1011111111101
 101    1000000000001
 101    1111111111111
 101
 101
 101
 101         11111111
 10111111111110000001
 10000000000000000001
 11111111111110000001
             11111111