NO textures/Bricks/Brick_Wall_64x64.png
EA textures/Dirt_Road_64x64.png
WE textures/Bricks/Brick_Wall_Cracked_64x64.png	
SO textures/Bricks/stone_64x64.png

F 107,79,58
C 135,206,250

               111111111
               100000001
   111111111111101111101
   10000000100000001 1011111
   100111N1000000001 1000001
   1010011110000000111111101
   1000000000000000001   101
   1000000000000011101   101
   1000000000000111101   101
   1000000000001110001   101
   1011111111111 10111   101
   101           101     101
   10111111 11111101     101
   1000000111000000111111101
   1111110000011110000000001
        1111111  11111111111