NO textures/Bricks/Brick_Wall_64x64.png
EA textures/Dirt_Road_64x64.png
WE textures/Bricks/Brick_Wall_Cracked_64x64.png	
SO textures/Bricks/stone_64x64.png

F 107,79,58
C 135,206,250

111111111111111
100000000000001
110111111110011111111
110111111110000000001
1000100000N1111111101
111111111011111   101
        101       101
        101       101
        101       101
        1011111111101
        1000000000001
        1111111011111
              101
              101
              101
             11011111
             10000001
             10000001
             10000001
             11111111

