   
   NO textures/Brick_Wall_64x64.png
EA textures/Dirt_Road_64x64.png

	WE textures/Brick_Wall_Cracked_64x64.png	
	  SO textures/stone_64x64.png

F 6B,4F,3a
C 87,Ce,FA


		     

		111111111111111111111111cd
100000000011000001110111111111111
11110111111111011100000010001
111101111111110111N1010010001
11000000110101011100000010001
10000000000000001100000010001
10000000000000001101010010001
110000011101010111110111100111
11110111 1110101 101111010001
11111111 1111111 111111111111



