NO ./textures_ids/nord.png
SO ./textures_ids/south.png
WE ./textures_ids/west.png
EA ./textures_ids/east.png

F 184,113,243
C 51,12,227

111111111111111111
111111021111111100
111111111111111111
111111111111111111
1111111111111111N1
111111111111111111